2020/04/04
17-09-1999
09-12/2017
9/11/2020
1819-12-09
27\08\2009
04-05*2020
011/09/2016
11-09-2016
12/15/2021
